BBBBBBB
B1B1B1B1BB
BB22222BBB
BBB3333BBB
BB11111BBB
BBBB2BBBBB
BB3BBBB3BB
BBBBBBBBBB
