BBBBBBB
BB22BBBBBB
BBBBBB33BB
BBBBBBBBBB
11BBBBBB22
BBBB333BBB
BB11BBBBBB
BBBBBB22BB
B333BBBBBB
22BBBBBB11
BBBBBBBBBB