BBBBBBBBB
B2B2B2B2B2BB
BB33333333BB
B111111111BB
BB22222222BB
B3B3B3B3B3BB
BBBBBBBBBBBB
